7,7,7,7,7,7,7,7,7,7,7,7,7,7,7,7,7,7,7,7,7,7,7,7,7,7,7,7,7,7,7,7,7,7,7,7,7,7,7,7,7,7,7,7,7,7,7,7,7,7,7,7,7,7,7,7,7,7,7,7,7,7,7,7,7,7,7,7,7,7,7,7,7,7,7,7,7,7,7,7,7,7,7,7,7,7,7,7,7,7,7,7,7,7,7,7,7,7,7,7,
7,7,7,7,7,7,7,7,7,7,7,7,7,7,7,7,7,7,7,7,7,7,7,7,7,7,7,7,7,7,7,7,7,7,7,7,7,7,7,7,7,7,7,7,7,7,7,7,7,7,7,7,7,7,7,7,7,7,7,7,7,7,7,7,7,7,7,7,7,7,7,7,7,7,7,7,7,7,7,7,7,7,7,7,7,7,7,7,7,7,7,7,7,7,7,7,7,7,7,7,
7,7,7,7,7,7,7,7,7,7,7,7,7,7,7,7,7,7,7,7,7,7,7,7,7,7,7,7,7,7,7,7,7,7,7,7,7,7,7,7,7,7,7,7,7,7,7,7,7,7,7,7,7,7,7,7,7,7,7,7,7,7,7,7,7,7,7,7,7,7,7,7,7,7,7,7,7,7,7,7,7,7,7,7,7,7,7,7,7,7,7,7,7,7,7,7,7,7,7,7,
7,7,7,7,7,7,7,7,7,7,7,7,7,7,7,7,7,7,7,7,7,7,7,7,7,7,7,7,7,7,7,7,7,7,7,7,7,7,7,7,7,7,7,7,7,7,7,7,7,7,7,7,7,7,7,7,7,7,7,7,7,7,7,7,7,7,7,7,7,7,7,7,7,7,7,7,7,7,7,7,7,7,7,7,7,7,7,7,7,7,7,7,7,7,7,7,7,7,7,7,
7,7,7,7,7,7,7,7,7,7,7,7,7,7,7,7,7,7,7,7,7,7,7,7,7,7,7,7,7,7,7,7,7,7,7,7,7,7,7,7,7,7,7,7,7,7,7,7,7,7,7,7,7,7,7,7,7,7,7,7,7,7,7,7,7,7,7,7,7,7,7,7,7,7,7,7,7,7,7,7,7,7,7,7,7,7,7,7,7,7,7,7,7,7,7,7,7,7,7,7,
7,7,7,7,7,7,857,858,859,860,861,862,863,864,865,866,867,7,7,7,984,7,7,987,7,7,7,7,7,7,7,7,7,7,7,7,7,7,7,7,7,7,7,7,7,7,7,7,7,7,7,7,7,7,7,7,7,7,7,7,7,7,7,7,7,7,7,7,7,7,7,7,7,7,7,7,7,7,7,7,7,7,7,7,7,7,7,7,7,7,7,7,7,7,7,7,7,7,7,7,
818,819,851,852,853,854,856,855,847,868,847,869,870,847,871,873,872,874,875,876,877,985,986,988,989,990,991,992,7,7,7,7,7,7,7,7,7,7,7,7,7,7,7,7,7,7,7,7,7,7,7,7,1142,1141,1140,1139,1138,1137,7,7,7,7,7,7,7,7,7,7,7,7,7,7,7,7,7,7,7,7,7,7,7,7,7,7,7,7,7,7,7,7,7,7,7,7,7,7,7,1322,1321,1320,
820,821,850,847,849,878,879,880,881,882,847,883,885,884,886,887,888,889,890,891,892,893,894,895,993,994,995,996,998,997,999,1000,1001,1002,1003,1004,1005,1006,1007,1008,1009,1010,1011,1012,1013,1014,1127,1128,1129,1130,1131,1132,1133,1134,847,847,847,1136,1135,1143,1144,1145,1146,1147,1148,1149,7,7,7,7,7,7,7,7,7,7,7,7,7,7,7,7,7,7,7,7,7,7,7,7,7,7,1314,1315,1316,1317,1318,1319,847,997,
823,822,846,847,848,896,897,898,899,900,901,902,903,904,905,906,907,908,909,910,911,912,913,914,1015,1016,994,1017,1018,1019,938,1020,847,994,1021,1022,847,1023,1024,1025,997,1026,893,847,1026,1027,847,1150,1151,1152,1153,1154,879,1155,879,1156,1158,1157,847,1159,1160,1161,1162,1163,1164,1165,1166,1167,1168,7,7,7,7,7,7,7,7,7,7,7,7,7,7,1305,1306,1307,1308,1309,1310,1311,1313,1312,994,1326,1056,883,1325,1324,1323,997,
824,825,843,845,844,915,916,917,918,919,920,921,922,923,924,925,926,927,928,929,930,931,932,933,1028,1029,1030,1031,1032,880,1033,1034,1035,1036,1037,1038,1039,1040,1041,1042,1043,1044,1045,1046,1047,1048,1169,1170,1171,1172,1173,1174,1130,1175,1176,1177,1178,1179,1180,1181,1182,1183,1184,1026,1026,1185,1186,1161,1187,1188,1189,1292,1293,1294,1295,1296,1297,1298,1299,1300,1301,1302,1303,1304,1327,1328,1329,1330,938,1331,1332,1333,994,1334,1335,883,1336,1337,1338,1339,
827,826,842,841,840,839,934,935,936,937,938,938,939,940,941,942,943,944,945,946,947,948,949,950,1049,1050,1051,1052,1053,1054,997,1055,1056,1057,1058,1059,1060,1061,1062,1063,1064,1065,1066,1067,1068,1069,1190,1191,1192,1193,1194,1195,1196,1197,1198,1199,1200,1201,1202,1203,1204,1205,1206,1207,1208,1209,1210,1211,1212,1213,1214,1340,1341,1342,1343,1344,883,994,847,1345,847,1346,847,1347,1348,883,1349,1350,1351,1352,1353,883,994,1354,1355,1356,1357,1358,1359,1360,
828,829,835,836,837,838,951,952,953,937,938,954,955,956,957,958,959,960,961,962,963,964,965,966,1070,1071,1072,1073,1074,1075,1076,1077,1056,1078,1079,1080,1081,1082,1083,1084,1085,1086,1087,1088,1089,1090,1215,1216,1217,1218,1219,1220,1221,1222,1223,1224,1225,1226,1227,1228,1229,1230,1231,1232,1233,1234,1235,1236,1237,1239,1238,1385,937,1384,1383,1382,1381,994,1380,1379,1378,1376,1377,1375,1374,883,1373,1372,1371,879,1370,1369,1368,1367,1366,1365,1364,1363,1362,1361,
8,830,831,834,833,832,967,968,969,970,971,972,973,974,8,975,976,977,978,979,980,981,982,983,1091,8,8,8,8,8,1092,1093,1094,1095,1096,1097,1098,1099,1100,1101,1102,1103,1104,1105,1106,1107,1240,1241,1242,1243,1244,1245,1246,1247,1248,1249,1250,1251,1252,1253,1254,1255,1256,1257,1258,1259,1260,1261,1262,1263,1264,1386,1387,1388,1389,1390,1391,1392,1393,1394,1395,1396,1183,938,1397,883,1398,1399,1400,1401,1402,1403,1404,1405,1406,1407,1408,1409,1410,1411,
8,8,8,8,8,8,8,8,8,8,8,8,8,8,8,8,8,8,8,8,8,8,8,8,8,8,8,8,8,8,8,1108,1109,1110,1111,1112,1113,1114,1115,1116,1117,1118,1119,1120,1121,1122,1265,1266,1267,1268,1269,1270,1271,1272,1273,1274,1275,1276,1277,1278,1279,1280,1281,1282,1283,1284,1285,1286,1287,1288,1289,1432,1431,1430,1428,1429,1427,1426,1425,1424,1423,1422,1421,1420,1419,1417,1418,1416,1415,1414,1413,1412,8,8,8,8,8,8,8,8,
8,8,8,8,8,8,8,8,8,8,8,8,8,8,8,8,8,8,8,8,8,8,8,8,8,8,8,8,8,8,8,8,8,8,8,8,8,1123,1124,1125,1126,8,8,8,8,8,8,8,8,8,8,8,8,8,8,8,8,8,8,8,8,8,8,8,8,8,8,8,8,1290,1291,8,8,1433,8,1434,1435,1436,1437,1438,1439,8,8,1440,1441,1442,1443,8,8,8,8,8,8,8,8,8,8,8,8,8,
8,8,8,8,8,8,8,8,8,8,8,8,8,8,8,8,8,8,8,8,8,8,8,8,8,8,8,8,8,8,8,8,8,8,8,8,8,8,8,8,8,8,8,8,8,8,8,8,8,8,8,8,8,8,8,8,8,8,8,8,8,8,8,8,8,8,8,8,8,8,8,8,8,8,8,8,8,8,8,8,8,8,8,8,8,8,8,8,8,8,8,8,8,8,8,8,8,8,8,8,

